11111111
1C0RPE01
10R10001
10010001
11111001
10001U11
1C1C0001
11111111