
11111
10001
10PE1
1C00
11111

