11111111
1C00P001
10010001
10010001
111110E1
10001011
1C1C0001
11111111