11111111
1C00P001
10010001
10010001
11111001
10001111
1C1C00E1
11111111