11111111
1C0000E1
10010001
10010001
10111001
10010101
1C0000P1
11111111