11111
10001
10PE1
1C	01
11111
	1234
				a
				 
11111





