11111111
1C00PE01
10010001
10010001
11111001
10001U11
1C1C0001
11111111