1111111
1E000C1
1R000D1
1C00001
10000P1
1111111