111111111111111111111111111
10P10000111010C011111111111
1E00011000000010000000000C1
111111111111111111111111111