11111111111111111111111111111111111
10000000000000000000000000000000001
10000000000000000000000000000000001
10000000000000000000000000000000001
1000000000P000000000000000000000001
10000000000000000000000000000000001
10000000000000000000000000000000001
1000000000000000000000000L000000001
100000000000000000U0000000000000001
10000000000000000000000000000000001
10000000C00000000000000000000000001
10000000000C00000000000000000000001
1000000R0000000C0000000000000000E01
10000000000000000000000000000000001
11111111111111111111111111111111111