1111111111111111111
10000D0000000000001
1000000000000000001
100000000L00R000001
100000100R00L000001
10R0L01111111110001
10L0R01C0D0U0D00001
100P0010000000000E1
1111111111111111111