1111111
10010C1
1P0E0C1
10010C1
1111111