1111111111111111
10P00CR0000000E1
1111111111111111